1111111111111111111111111111111111111111
1111110000000000000000000000000000000001
1111110000000000000000000000000000000001
1111100001000000000000000000000000000001
11100@0100000000000100000000010000000001
1110111111111011100000011100000011111101
1110111111111111111111111111111111111101
1110110000000000000000000000000000000001
1110110000000000100000100000000000000001
1110110000000000000000000000000011000001
1110110111110000001110000001110000001111
1110110111111111111111111111111111111111
1110110000000000000000000000000000000011
1110110000000000000000000000000000000011
1110110001000000000000000000000000000011
1110111110000001110000001110000001111111
1110111111111111111111111111111111111111
1110111111111111111111111111111111111111
1100111111111111111111111111111111111111
1110000011111000000000000000000000000001
1111000000000000000000000000000000000001
1111000000000000000000000000000000000001
1111000000001000000000000000000000000001
11110001110000<0000000000000000000000001
1111111000000000000000000000000000000001
1111111111111111111111111111111111111111
1111111111111111111111111111111111111111
1111111111111111111111111111111111111111
1111111111111111111111111111111111111111
1111111111111111111111111111111111111111
1111111111111111111111111111111111111111
1111111111111111111111111111111111111111
ANONYMOUS
CAVE
4
4
4
NONE
2


1